                                                              0                                                                                                          L                               
             ===========================================  =======                                            ?  ===                                                      L                               
                                                        =+                                                    a   aaa   a                                                L-                              
                                                                                                             aaa  a aa aaa                                               LF                              
                                   s                                  abaaaaaaaaa                           aa aaaa  aya aaa      =+                                     X=         a  aaaaa             
            =======================X                                  aXXXX?====a                          aaX  ===   ~-  +a                                +              +       a aaa  Ca             
                                                  a    ayaa           aX        a  aaa                    aaXX  0     LF   a aaaa aa     aaa    ayaa              aa              +a  ~-  Ma             
                                         aa   aa aaa   a~-a           aX        a a  aa                  aaXXX        LF   aa ~-aa a    a  aa   a~-a             a  a             aa  LF  Ca             
T         aaaaaaaaaaaaaaaaaaaaaaaaaaaaaaaaaaaaaaaa aaaaaLFaaaaasaaaaaaaX        aaa   aaaaaaaaaaaaaaaaaaaaXXXX  s     LF   aa LFaa aaaaaa   aaaagLFaaggaasaaaaaaaa  aaaaaaaaaaaaaaa   LF  HaaabaaaaaaaaaE
NNNNNNNNNNNNNNNNNNNNNNNNNNNNNNNNNNNNNNNNNN NNNN NN  NNNNNNNNNNNNNNNNNNNNNNNNNNNNNNN    NNNNNNNNNNNNNNNNNNNNNNNNNNNNNNNNNNNNNN NNNN  NNNNN    NNNNNNNNNNNNNNNNNNNNN   NNNNNNNNNNNNNN   NNNNNNNNNNNNNNNNNNN
