                                                                                                                                                          aaaa            aaaa                           
                                                                     ==========                                                                          aaXXa           aaXXa                           
                                                                                                    +0                                                  aaXXXa          aaXXXa                           
                                                                                                                                                       aaXXXXa         aaXXXXa                           
                               ayaa                      aa                                                                  ++                       agXXXXXa        aaXXXXXa                           
                               a~-a                      aaa         ==========                   ======                                             aaXXXXXXa       aaXXXXXXa                           
                               aLFa                     aaXa                                                                                        aaXXXXXXXa      aaXXXXXXXa                           
                               aLFa                     a Xaa                                                                                      aaXXXXXXXXa     aaXXXXXXXXa                           
T         aaaaaaaaaaaaaaaaaaaaaaLFaaaaaaaaaaaaagaaaaaaaaa X aaaaaaaaaaaaaaaaaaaaaabaaagaaaaaaaaaaaaaaaaaaaabagaaaaaaaaaaaaaaaaabaaaaaaaaagaaaaaaaaaaXXXXXXXXXaaaaaaaXXXXXXXXXaaaaaaaaaaaaaaaaabaaaaaaaaaE
NNNNNNNNNNNNNNNNNNNNNNNNNNNNNNNNNNNNNNNNNNNNNNNNNNNNNNNNNNNNNNNNNNNNNNNNNNNNNNNNNNNNNNNNNNNNNNNNNNNNNNNNNNNNNNNNNNNNNNNNNNNNNNNNNNNNNNNNNNNNNNNNNNNNNNNNNNNNNNNNNNNNNNNNNNNNNNNNNNNNNNNNNNNNNNNNNNNNNNNNN
